M10
res/img/lvl10icon.png
30
17
3
32
32
B
XX XX XX XX XX XX XX XX XX XX XX XX XX XX XX XX XX XX XX XX XX XX XX XX XX XX XX XX XX XX 
XX XX XX XX XX XX XX XX XX XX XX XX XX XX XX G0 G0 G0 G0 G0 G0 G0 G0 G0 G0 G0 G0 G0 G0 G0
XX XX XX XX XX XX XX XX XX XX XX XX XX XX XX G0 G0 G0 G0 G0 G0 G0 G0 G0 G0 G0 G0 G0 G0 G0 
XX XX XX XX XX XX XX XX XX XX XX XX XX XX XX G0 G0 G0 G0 G0 G0 G0 G0 G0 G0 G0 G0 G0 G0 G0
XX XX XX XX XX XX XX XX XX XX XX XX XX XX XX G0 G0 G0 G0 G0 G0 G0 G0 G0 G0 G0 G0 G0 G0 G0 
XX XX XX XX XX XX XX XX XX XX XX XX XX XX XX XX XX XX XX XX XX XX XX XX XX XX XX G0 G0 XX
XX XX XX XX XX XX XX XX XX XX XX XX XX XX XX XX XX XX XX XX XX XX XX XX XX XX XX G0 G0 XX 
XX XX XX XX XX XX XX XX XX XX XX XX XX XX XX XX XX XX XX XX XX XX XX XX XX XX XX G0 G0 XX
XX XX XX XX XX XX XX XX XX XX XX XX XX XX XX XX XX XX XX XX XX XX XX XX XX XX XX G0 G0 XX
XX XX XX XX XX XX XX XX XX XX XX XX XX XX XX XX XX XX XX XX XX XX XX XX XX XX XX G0 G0 XX 
XX G0 G0 G0 XX G0 XX XX XX XX XX XX XX XX XX XX XX XX XX XX G0 G0 G0 G0 G0 G0 G0 G0 G0 XX
XX G0 G0 G0 G0 G0 XX XX XX XX XX XX XX XX XX XX XX XX XX XX G0 G0 G0 G0 G0 G0 G0 G0 G0 XX
XX G0 G0 G0 G0 G0 G0 G0 G0 G0 G0 XX XX XX XX XX XX XX XX XX G0 G0 G0 G0 G0 G0 G0 G0 G0 XX 
XX G0 G0 G0 G0 G0 G0 G0 G0 G0 G0 XX XX XX G0 XX XX XX XX XX G0 G0 G0 G0 G0 G0 G0 G0 G0 XX
XX G0 G0 G0 G0 G0 G0 G0 G0 G0 G0 G0 G0 G0 G0 XX XX XX XX XX G0 G0 G0 G0 G0 G0 G0 G0 G0 XX
XX G0 G0 G0 G0 G0 G0 G0 G0 G0 G0 G0 G0 G0 G0 XX XX XX XX XX G0 G0 G0 G0 G0 G0 G0 G0 G0 XX 
XX XX XX XX XX XX XX XX XX XX XX XX XX XX XX XX XX XX XX XX XX XX XX XX XX XX XX XX XX XX  
O
VE VE VE VE VE VE VE VE VE VE VE VE VE VE VE VE VE VE VE VE VE VE VE VE VE VE VE VE VE VE 
VE VE VE VE VE VE VE VE VE VE VE VE VE VE VE XX XX XX XX XX XX XX XX XX XX XX XX XX XX VE 
VE VE VE VE VE VE VE VE VE VE VE VE VE VE VE XX XX XX XX XX XX XX XX XX XX XX XX XX XX VE 
VE VE VE VE VE VE VE XX XX XX XX XX XX XX VE XX XX XX XX XX XX XX XX XX XX XX XX XX XX VE 
VE VE VE VE VE VE VE XX XX XX XX XX XX XX VE VE XX XX XX XX XX XX XX XX XX XX XX XX XX VE 
VE XX XX XX XX XX XX XX XX XX XX XX XX XX VE VE VE VE VE VE VE VE VE VE L2 VE VE VE VE VE 
VE XX XX XX XX XX XX XX XX XX XX XX XX XX XX XX XX XX XX XX XX XX XX XX L0 XX VE XX XX VE 
VE XX XX XX XX XX XX XX XX XX XX XX XX XX XX XX XX XX XX XX XX XX XX XX L0 XX VE XX XX VE 
VE VE VE VE VE VE XX XX XX XX XX XX XX XX XX XX XX XX XX XX XX XX XX XX L1 XX VE XX XX VE 
VE VE VE VE VE VE VE XX XX XX XX XX XX XX XX XX XX XX XX XX XX VE VE VE VE VE VE XX XX VE 
VE XX XX XX VE VE VE VE XX XX XX XX XX XX XX XX XX XX XX VE L2 XX XX XX XX XX VE XX XX VE 
VE XX XX XX VE XX VE VE VE VE VE VE XX XX XX XX XX XX VE VE L0 XX XX XX XX XX VE XX XX VE 
VE XX XX XX VE XX XX XX XX XX XX VE VE XX XX XX XX VE VE VE L0 XX XX XX XX XX XX XX XX VE 
VE XX XX XX VE XX XX XX XX XX XX VE VE VE L2 VE VE VE VE VE L0 XX XX XX XX XX XX XX XX VE
VE XX XX XX VE XX XX XX XX XX XX VE XX XX L0 VE VE VE VE VE L1 XX XX XX XX XX XX XX XX VE 
VE XX XX XX XX XX XX XX XX XX XX XX XX XX L1 VE VE VE VE VE VE VE VE VE VE VE VE VE VE VE 
VE VE VE VE VE VE VE VE VE VE VE VE VE VE VE VE VE VE VE VE VE VE VE VE VE VE VE VE VE VE
C
XX XX XX XX XX XX XX XX XX XX XX XX XX XX XX XX XX XX XX XX XX XX XX XX XX XX XX XX XX XX
XX XX XX XX XX XX XX XX XX XX XX XX XX XX XX XX XX XX XX XX XX XX XX XX XX XX XX XX XX XX
XX XX XX XX XX XX XX XX XX XX XX XX XX XX XX XX XX XX XX XX XX XX XX XX XX XX XX XX XX XX
XX XX XX XX XX XX XX XX XX XX XX XX XX XX XX XX XX XX XX XX XX XX XX XX XX XX XX XX XX XX
XX XX XX XX XX XX XX XX XX XX XX XX XX XX XX XX XX XX XX XX XX XX XX XX XX XX XX XX XX XX
XX XX XX XX XX XX XX XX XX XX XX XX XX XX XX XX XX XX XX XX XX XX XX XX XX XX XX XX XX XX
XX XX XX XX XX XX XX XX XX XX XX XX XX XX XX XX XX XX XX XX XX XX XX XX XX XX XX XX XX XX
XX XX XX XX XX XX XX XX XX XX XX XX XX XX XX XX XX XX XX XX XX XX XX XX XX XX XX XX XX XX
XX XX XX XX XX XX XX XX XX XX XX XX XX XX XX XX XX XX XX XX XX XX XX XX XX XX XX XX XX XX
XX XX XX XX XX XX XX XX XX XX XX XX XX XX XX XX XX XX XX XX XX XX XX XX XX XX XX XX XX XX
XX XX XX XX XX XX XX XX XX XX XX XX XX XX XX XX XX XX XX XX XX XX XX XX XX XX XX XX XX XX
XX XX XX XX XX XX XX XX XX XX XX XX XX XX XX XX XX XX XX XX XX XX XX XX XX XX XX XX XX XX
XX XX XX XX XX XX XX XX XX XX XX XX XX XX XX XX XX XX XX XX XX XX XX XX XX XX XX XX XX XX
XX XX XX XX XX XX XX XX XX XX XX XX XX XX XX XX XX XX XX XX XX XX XX XX XX XX XX XX XX XX
XX XX XX XX XX XX XX XX XX XX XX XX XX XX XX XX XX XX XX XX XX XX XX XX XX XX XX XX XX XX
XX XX XX XX XX XX XX XX XX XX XX XX XX XX XX XX XX XX XX XX XX XX XX XX XX XX XX XX XX XX
XX XX XX XX XX XX XX XX XX XX XX XX XX XX XX XX XX XX XX XX XX XX XX XX XX XX XX XX XX XX
I
6
ME
F1
912 448
MP
F2
160 416
288 416
40
1
1
MP
F3
480 321
352 269
120
0
1
MP
F4
672 353
768 353
50
0
1
IS
490 100
F3
PP
695 271
F4
PHY
2
SQ
869 138
SQ
46 230
C
5
SE
224 384
SE
260 96
SE
674 320
SE
804 320
GR
688 146
P
56 480