M11
res/img/lvl11icon.png
30
17
3
32
32
B
XX XX XX XX XX XX XX XX XX XX XX XX XX XX XX XX XX XX XX XX XX XX XX XX XX XX XX XX XX XX 
XX XX XX XX XX XX XX XX XX XX XX XX XX XX XX XX XX XX XX XX XX XX XX XX XX XX XX XX XX XX
XX XX XX XX XX XX XX XX XX XX XX XX XX XX XX XX XX XX XX XX XX XX XX XX XX XX XX XX XX XX 
XX XX XX XX XX XX XX XX XX XX XX XX XX XX XX XX XX XX XX XX XX XX XX XX XX XX XX XX XX XX
XX XX XX XX XX XX XX XX XX XX XX XX XX XX XX XX XX XX XX XX XX XX XX XX XX XX XX XX XX XX 
XX XX XX XX XX XX XX XX XX XX XX XX XX XX XX XX XX XX XX XX XX XX XX XX XX XX XX XX XX XX
XX XX XX XX XX XX XX XX XX XX XX XX XX XX XX XX XX XX XX XX XX XX XX XX XX XX XX XX XX XX 
XX XX XX XX XX XX XX XX XX XX XX XX XX XX XX XX XX XX XX XX XX XX XX XX XX XX XX XX XX XX
XX XX XX XX XX XX XX XX XX XX XX XX XX XX XX XX XX XX XX XX XX XX XX XX XX XX XX XX XX XX
XX XX XX XX XX XX XX XX XX XX XX XX XX XX XX XX XX XX XX XX XX XX XX XX XX XX XX XX XX XX 
XX XX XX XX XX XX XX XX XX XX XX XX XX XX XX XX XX XX XX XX XX XX XX XX XX XX XX XX XX XX
XX XX XX XX XX XX XX XX XX XX XX XX XX XX XX XX XX XX XX XX XX XX XX XX XX XX XX XX XX XX
XX XX XX XX XX XX XX XX XX XX XX XX XX XX XX XX XX XX XX XX XX XX XX XX XX XX XX XX XX XX 
XX XX XX XX XX XX XX XX XX XX XX XX XX XX XX XX XX XX XX XX XX XX XX XX XX XX XX XX XX XX
XX XX XX XX XX XX XX XX XX XX XX XX XX XX XX XX XX XX XX XX XX XX XX XX XX XX XX XX XX XX
XX XX XX XX XX XX XX XX XX XX XX XX XX XX XX XX XX XX XX XX XX XX XX XX XX XX XX XX XX XX 
XX XX XX XX XX XX XX XX XX XX XX XX XX XX XX XX XX XX XX XX XX XX XX XX XX XX XX XX XX XX  
O
VE VE VE VE VE VE VE VE VE VE VE VE VE VE VE VE VE VE VE VE VE VE VE VE VE VE VE VE VE VE 
VE XX XX XX XX L0 XX XX XX XX XX XX XX XX XX XX XX XX XX XX XX XX XX VE VE VE VE VE VE VE 
VE VE VE VE VE L1 XX XX XX XX XX XX XX XX XX XX XX XX XX XX XX XX XX VE VE VE VE VE VE VE 
VE VE VE VE XX XX XX XX XX XX VE XX XX XX XX XX XX XX VE XX XX XX XX VE XX XX XX XX XX VE 
VE XX XX XX XX XX XX XX XX VE VE VE VE VE VE VE VE VE VE VE VE XX XX XX XX XX XX XX XX VE 
VE XX XX XX XX XX XX XX VE VE VE VE VE VE VE VE VE VE VE VE VE VE VE VE XX XX XX XX XX VE 
VE XX XX XX VE VE VE VE VE VE XX XX XX XX XX VE VE VE VE VE VE VE VE VE XX XX XX XX XX VE 
VE XX VE VE VE VE VE XX XX XX XX XX VE XX XX VE VE VE VE VE VE VE VE VE VE VE XX XX XX VE 
VE XX VE XX XX XX XX XX XX XX XX XX VE XX XX VE VE XX XX XX XX XX VE VE VE VE XX XX XX VE 
VE XX VE XX XX XX XX XX XX XX XX XX VE XX XX VE VE XX XX XX XX XX VE VE XX XX XX XX XX VE 
VE XX VE XX XX XX XX XX VE VE XX XX VE XX XX VE VE XX XX XX XX XX VE XX XX XX XX XX XX VE 
VE XX VE XX XX XX XX XX VE VE XX XX VE XX XX VE XX XX XX XX XX XX VE VE XX XX XX XX XX VE 
VE XX VE XX XX XX XX VE VE VE XX XX VE XX XX XX XX XX XX XX XX XX XX XX XX XX XX XX XX VE 
VE XX VE XX XX XX XX VE VE VE XX XX XX VE VE XX XX XX XX XX XX XX XX XX XX XX XX XX XX VE
VE XX VE XX XX VE VE VE VE VE XX XX XX XX XX XX XX XX XX XX XX XX XX VE VE VE VE VE VE VE 
VE XX VE VE VE VE VE VE VE VE VE VE VE VE VE VE VE VE XX XX XX XX VE VE VE VE VE VE VE VE 
VE VE VE VE VE VE VE VE VE VE VE VE VE VE VE VE VE VE VE VE VE VE VE VE VE VE VE VE VE VE
C
XX XX XX XX XX XX XX XX XX XX XX XX XX XX XX XX XX XX XX XX XX XX XX XX XX XX XX XX XX XX
XX XX XX XX XX XX XX XX XX XX XX XX XX XX XX XX XX XX XX XX XX XX XX XX XX XX XX XX XX XX
XX XX XX XX XX XX XX XX XX XX XX XX XX XX XX XX XX XX XX XX XX XX XX XX XX XX XX XX XX XX
XX XX XX XX XX XX XX XX XX XX XX XX XX XX XX XX XX XX XX XX XX XX XX XX XX XX XX XX XX XX
XX XX XX XX XX XX XX XX XX XX XX XX XX XX XX XX XX XX XX XX XX XX XX XX XX XX XX XX XX XX
XX XX XX XX XX XX XX XX XX XX XX XX XX XX XX XX XX XX XX XX XX XX XX XX XX XX XX XX XX XX
XX XX XX XX XX XX XX XX XX XX XX XX XX XX XX XX XX XX XX XX XX XX XX XX XX XX XX XX XX XX
XX XX XX XX XX XX XX XX XX XX XX XX XX XX XX XX XX XX XX XX XX XX XX XX XX XX XX XX XX XX
XX XX XX XX XX XX XX XX XX XX XX XX XX XX XX XX XX XX XX XX XX XX XX XX XX XX XX XX XX XX
XX XX XX XX XX XX XX XX XX XX XX XX XX XX XX XX XX XX XX XX XX XX XX XX XX XX XX XX XX XX
XX XX XX XX XX XX XX XX XX XX XX XX XX XX XX XX XX XX XX XX XX XX XX XX XX XX XX XX XX XX
XX XX XX XX XX XX XX XX XX XX XX XX XX XX XX XX XX XX XX XX XX XX XX XX XX XX XX XX XX XX
XX XX XX XX XX XX XX XX XX XX XX XX XX XX XX XX XX XX XX XX XX XX XX XX XX XX XX XX XX XX
XX XX XX XX XX XX XX XX XX XX XX XX XX XX XX XX XX XX XX XX XX XX XX XX XX XX XX XX XX XX
XX XX XX XX XX XX XX XX XX XX XX XX XX XX XX XX XX XX XX XX XX XX XX XX XX XX XX XX XX XX
XX XX XX XX XX XX XX XX XX XX XX XX XX XX XX XX XX XX XX XX XX XX XX XX XX XX XX XX XX XX
XX XX XX XX XX XX XX XX XX XX XX XX XX XX XX XX XX XX XX XX XX XX XX XX XX XX XX XX XX XX
I
9
ME
F1
32 32
MP
F2
320 318
320 452
50
0
0
MP
F3
864 420
864 288
80
0
1
MP
F4
128 96
176 96
50
0
0
MP
F5
32 204
64 204
50
0
0
PP
418 400
F2
IS
752 324
F3
PP
30 496
F4
PP
130 176
F5
PHY
1
SQ
184 428
C
3
SE
558 256
GR
470 108
GR
554 108
P
108 457