M02
res/img/lvl2icon.png
30
17
3
32
32
B
XX XX XX XX XX XX XX XX XX XX XX XX XX XX XX XX XX XX XX XX XX XX XX XX XX XX XX XX XX XX 
XX XX XX XX XX XX XX XX XX XX XX XX XX XX XX XX XX XX XX XX XX XX XX XX XX XX XX XX XX XX
XX XX XX XX XX XX XX XX XX XX XX XX XX XX XX XX XX XX XX XX XX XX XX XX XX XX XX XX XX XX 
XX XX XX XX XX XX XX XX XX XX XX XX XX XX XX XX XX XX XX XX XX XX XX XX XX XX XX XX XX XX
XX XX XX XX XX XX XX XX XX XX XX XX XX XX XX XX XX XX XX XX XX XX XX XX XX XX XX XX XX XX 
XX XX XX XX XX XX XX XX XX XX XX XX XX XX XX XX XX XX XX XX XX XX XX XX XX XX XX XX XX XX
XX XX XX XX XX XX XX XX XX XX XX XX XX XX XX XX XX XX XX XX XX XX XX XX XX XX XX XX XX XX 
XX XX XX XX XX XX XX XX XX XX XX XX XX XX XX XX XX XX XX XX XX XX XX XX XX XX XX XX XX XX
XX XX XX XX XX XX XX XX XX XX XX XX XX XX XX XX XX XX XX XX XX XX XX XX XX XX XX XX XX XX
XX XX XX XX XX XX XX XX XX XX XX XX XX XX XX XX XX XX XX XX XX XX XX XX XX XX XX XX XX XX 
XX XX XX XX XX XX XX XX XX XX XX XX XX XX XX XX XX XX XX XX XX XX XX XX XX XX XX XX XX XX
XX XX XX XX XX XX XX XX XX XX XX XX XX XX XX XX XX XX XX XX XX XX XX XX XX XX XX XX XX XX
XX XX XX XX XX XX XX XX XX XX XX XX XX XX XX XX XX XX XX XX XX XX XX XX XX XX XX XX XX XX 
XX XX XX XX XX XX XX XX XX XX XX XX XX XX XX XX XX XX XX XX XX XX XX XX XX XX XX XX XX XX
XX XX XX XX XX XX XX XX XX XX XX XX XX XX XX XX XX XX XX XX XX XX XX XX XX XX XX XX XX XX
XX XX XX XX XX XX XX XX XX XX XX XX XX XX XX XX XX XX XX XX XX XX XX XX XX XX XX XX XX XX 
XX XX XX XX XX XX XX XX XX XX XX XX XX XX XX XX XX XX XX XX XX XX XX XX XX XX XX XX XX XX  
O
W2 W0 W0 W0 W0 W0 W0 W0 W0 W0 W0 W0 W0 W0 W0 W0 W0 W0 W0 W0 W0 W0 W0 W0 W0 W0 W0 W0 W0 W3 
W1 W5 XX XX XX XX XX XX XX XX XX XX XX XX VE XX XX XX XX XX XX XX XX XX XX XX XX VE VE W1 
W1 XX XX XX XX XX XX XX XX XX XX XX XX XX VE XX XX XX XX XX XX XX XX XX XX XX XX VE VE W1 
W1 XX XX XX XX XX XX XX XX XX XX XX XX XX VE XX XX XX XX XX XX XX XX XX XX XX XX VE VE W1 
W1 XX XX XX XX XX XX XX XX XX XX XX XX XX VE L2 VE VE XX VE VE VE VE XX XX XX XX VE VE W1 
W1 XX XX XX XX XX XX XX XX XX XX XX XX XX VE L0 XX XX XX VE VE VE VE XX XX XX XX VE VE W1 
W1 XX XX XX XX XX XX XX XX XX XX XX XX XX VE L0 XX XX XX XX XX XX VE XX XX XX XX VE VE W1 
W1 XX XX XX XX XX XX XX XX XX XX XX XX XX VE L1 XX XX XX XX XX XX VE XX XX XX XX VE VE W1 
W1 XX XX XX XX XX XX XX XX XX XX XX XX XX VE VE VE XX XX VE VE L2 VE XX XX XX XX VE VE W1 
W1 XX XX XX XX XX XX XX VE VE VE XX XX XX XX XX XX XX XX XX VE L0 VE XX XX XX XX VE VE W1 
W1 XX XX XX XX XX XX XX XX XX XX XX XX XX XX XX XX XX XX XX XX L0 VE XX XX XX XX VE VE W1 
W1 XX XX XX XX XX VE VE VE VE VE VE XX XX XX XX XX XX XX XX XX L1 VE XX XX XX XX VE VE W1 
W1 XX XX XX VE XX VE VE VE VE VE VE XX XX XX XX XX VE XX VE VE VE VE XX XX XX XX XX XX W1 
W1 VE VE VE VE VE VE VE VE VE VE VE XX XX VE VE VE VE XX VE VE VE VE VE VE VE VE VE VE W1
W1 VE VE VE VE VE VE VE VE VE VE VE XX XX VE VE VE VE XX VE VE VE VE VE VE VE VE VE VE W1 
W1 VE VE VE VE VE VE VE VE VE VE VE XX XX VE VE VE VE XX VE VE VE VE VE VE VE VE VE VE W1 
W4 W0 W0 W0 W0 W0 W0 W0 W0 W0 W0 W0 XX XX W0 W0 W0 W0 XX W0 W0 W0 W0 W0 W0 W0 W0 W0 W0 W5 
C
XX XX XX XX XX XX XX XX XX XX XX XX XX XX XX XX XX XX XX XX XX XX XX XX XX XX XX XX XX XX
XX XX XX XX XX XX XX XX XX XX XX XX XX XX XX XX XX XX XX XX XX XX XX XX XX XX XX XX XX XX
XX XX XX XX XX XX XX XX XX XX XX XX XX XX XX XX XX XX XX XX XX XX XX XX XX XX XX XX XX XX
XX XX XX XX XX XX XX XX XX XX XX XX XX XX XX XX XX XX XX XX XX XX XX XX XX XX XX XX XX XX
XX XX XX XX XX XX XX XX XX XX XX XX XX XX XX XX XX XX XX XX XX XX XX XX XX XX XX XX XX XX
XX XX XX XX XX XX XX XX XX XX XX XX XX XX XX XX XX XX XX XX XX XX XX XX XX XX XX XX XX XX
XX XX XX XX XX XX XX XX XX XX XX XX XX XX XX XX XX XX XX XX XX XX XX XX XX XX XX XX XX XX
XX XX XX XX XX XX XX XX XX XX XX XX XX XX XX XX XX XX XX XX XX XX XX XX XX XX XX XX XX XX
XX XX XX XX XX XX XX XX XX XX XX XX XX XX XX XX XX XX XX XX XX XX XX XX XX XX XX XX XX XX
XX XX XX XX XX XX XX XX XX XX XX XX XX XX XX XX XX XX XX XX XX XX XX XX XX XX XX XX XX XX
XX XX XX XX XX XX XX XX XX XX XX XX XX XX XX XX XX XX XX XX XX XX XX XX XX XX XX XX XX XX
XX XX XX XX XX XX XX XX XX XX XX XX XX XX XX XX XX XX XX XX XX XX XX XX XX XX XX XX XX XX
XX XX XX XX XX XX XX XX XX XX XX XX XX XX XX XX XX XX XX XX XX XX XX XX XX XX XX XX XX XX
XX XX XX XX XX XX XX XX XX XX XX XX XX XX XX XX XX XX XX XX XX XX XX XX XX XX XX XX XX XX
XX XX XX XX XX XX XX XX XX XX XX XX XX XX XX XX XX XX XX XX XX XX XX XX XX XX XX XX XX XX
XX XX XX XX XX XX XX XX XX XX XX XX XX XX XX XX XX XX XX XX XX XX XX XX XX XX XX XX XX XX
XX XX XX XX XX XX XX XX XX XX XX XX XX XX XX XX XX XX XX XX XX XX XX XX XX XX XX XX XX XX
I
1
ME
F1
908 384
PHY
0
C
0
P
50 380