M02
res/img/lvl2icon.png
30
17
3
32
32
B
XX XX XX XX XX XX XX XX XX XX XX XX XX XX XX XX XX XX XX XX XX XX XX XX XX XX XX XX XX XX 
XX XX XX XX XX XX XX XX XX XX XX XX XX XX XX XX XX XX XX XX XX XX XX XX XX XX XX XX XX XX
XX XX XX XX XX XX XX XX XX XX XX XX XX XX XX XX XX XX XX XX XX XX XX XX XX XX XX XX XX XX 
XX XX XX XX XX XX XX XX XX XX XX XX XX XX XX XX XX XX XX XX XX XX XX XX XX XX XX XX XX XX
XX XX XX XX XX XX XX XX XX XX XX XX XX XX XX XX XX XX XX XX XX XX XX XX XX XX XX XX XX XX 
XX XX XX XX XX XX XX XX XX XX XX XX XX XX XX XX XX XX XX XX XX XX XX XX XX XX XX XX XX XX
XX XX XX XX XX XX XX XX XX XX XX XX XX XX XX XX XX XX XX XX XX XX XX XX XX XX XX XX XX XX 
XX XX XX XX XX XX XX XX XX XX XX XX XX XX XX XX XX XX XX XX XX XX XX XX XX XX XX XX XX XX
XX XX XX XX XX XX XX XX XX XX XX XX XX XX XX XX XX XX XX XX XX XX XX XX XX XX XX XX XX XX
XX XX XX XX XX XX XX XX XX XX XX XX XX XX XX XX XX XX XX XX XX XX XX XX XX XX XX XX XX XX 
XX XX XX XX XX XX XX XX XX XX XX XX XX XX XX XX XX XX XX XX XX XX XX XX XX XX XX XX XX XX
XX XX XX XX XX XX XX XX XX XX XX XX XX XX XX XX XX XX XX XX XX XX XX XX XX XX XX XX XX XX
XX XX XX XX XX XX XX XX XX XX XX XX XX XX XX XX XX XX XX XX XX XX XX XX XX XX XX XX XX XX 
XX XX XX XX XX XX XX XX XX XX XX XX XX XX XX XX XX XX XX XX XX XX XX XX XX XX XX XX XX XX
XX XX XX XX XX XX XX XX XX XX XX XX XX XX XX XX XX XX XX XX XX XX XX XX XX XX XX XX XX XX
XX XX XX XX XX XX XX XX XX XX XX XX XX XX XX XX XX XX XX XX XX XX XX XX XX XX XX XX XX XX 
XX XX XX XX XX XX XX XX XX XX XX XX XX XX XX XX XX XX XX XX XX XX XX XX XX XX XX XX XX XX  
O
W3 XX XX XX XX XX XX XX XX XX XX XX XX XX W4 XX XX XX XX XX XX XX XX XX XX XX XX W1 W2 W3 
W3 XX XX XX XX XX XX XX XX XX XX XX XX XX W4 XX XX XX XX XX XX XX XX XX XX XX XX W1 W2 W2 
W3 XX XX XX XX XX XX XX XX XX XX XX XX XX W4 XX XX XX XX XX XX XX XX XX XX XX XX W1 W2 W2 
W3 XX XX XX XX XX XX XX XX XX XX XX XX XX W4 XX XX XX XX XX XX XX XX XX XX XX XX W1 W2 W2 
W3 XX XX XX XX XX XX XX XX XX XX XX XX XX W4 L2 VE VE XX VE VE VE VE XX XX XX XX W1 W2 W2 
W3 XX XX XX XX XX XX XX XX XX XX XX XX XX W4 L0 XX XX XX XX VE VE VE XX XX XX XX W1 W2 W2 
W3 XX XX XX XX XX XX XX XX XX XX XX XX XX W4 L0 XX XX XX XX XX XX VE XX XX XX XX W1 W2 W2 
W3 XX XX XX XX XX XX XX XX XX XX XX XX XX W4 L1 XX XX XX XX XX XX VE XX XX XX XX W1 W2 W2 
W3 XX XX XX XX XX XX XX XX XX XX XX XX XX VE VE VE XX XX VE VE L2 VE XX XX XX XX W1 W2 W2 
W3 XX XX XX XX XX XX XX VE VE VE XX XX XX XX XX XX XX XX XX VE L0 VE XX XX XX XX W1 W2 W2 
W3 XX XX XX XX XX XX XX XX XX XX XX XX XX XX XX XX XX XX XX XX L0 VE XX XX XX XX W1 W2 W2 
W3 XX XX XX XX XX W6 W0 W0 W0 W0 W7 XX XX XX XX XX XX XX XX XX L1 VE XX XX XX XX W8 WE W2 
W3 XX XX XX VE XX W1 W2 W2 W2 W2 W3 XX XX XX XX XX VE XX W6 W0 W0 W7 XX XX XX XX XX XX W1 
W2 W0 W0 W0 W0 W0 W2 W2 W2 W2 W2 W3 XX XX W6 W0 W0 W7 XX W1 W2 W2 W2 W0 W0 W0 W0 W0 W0 W2
W2 W2 W2 W2 W2 W2 W2 W2 W2 W2 W2 W3 XX XX W1 W2 W2 W3 XX W1 W2 W2 W2 W2 W2 W2 W2 W2 W2 W2 
W2 W2 W2 W2 W2 W2 W2 W2 W2 W2 W2 W3 XX XX W1 W2 W2 W3 XX W1 W2 W2 W2 W2 W2 W2 W2 W2 W2 W2 
W2 W2 W2 W2 W2 W2 W2 W2 W2 W2 W2 W3 XX XX W1 W2 W2 W3 XX W1 W2 W2 W2 W2 W2 W2 W2 W2 W2 W2 
C
XX XX XX XX XX XX XX XX XX XX XX XX XX XX XX XX XX XX XX XX XX XX XX XX XX XX XX XX XX XX
XX XX XX XX XX XX XX XX XX XX XX XX XX XX XX XX XX XX XX XX XX XX XX XX XX XX XX XX XX XX
XX XX XX XX XX XX XX XX XX XX XX XX XX XX XX XX XX XX XX XX XX XX XX XX XX XX XX XX XX XX
XX XX XX XX XX XX XX XX XX XX XX XX XX XX XX XX XX XX XX XX XX XX XX XX XX XX XX XX XX XX
XX XX XX XX XX XX XX XX XX XX XX XX XX XX XX XX XX XX XX XX XX XX XX XX XX XX XX XX XX XX
XX XX XX XX XX XX XX XX XX XX XX XX XX XX XX XX XX XX XX XX XX XX XX XX XX XX XX XX XX XX
XX XX XX XX XX XX XX XX XX XX XX XX XX XX XX XX XX XX XX XX XX XX XX XX XX XX XX XX XX XX
XX XX XX XX XX XX XX XX XX XX XX XX XX XX XX XX XX XX XX XX XX XX XX XX XX XX XX XX XX XX
XX XX XX XX XX XX XX XX XX XX XX XX XX XX XX XX XX XX XX XX XX XX XX XX XX XX XX XX XX XX
XX XX XX XX XX XX XX XX XX XX XX XX XX XX XX XX XX XX XX XX XX XX XX XX XX XX XX XX XX XX
XX XX XX XX XX XX XX XX XX XX XX XX XX XX XX XX XX XX XX XX XX XX XX XX XX XX XX XX XX XX
XX XX XX XX XX XX XX XX XX XX XX XX XX XX XX XX XX XX XX XX XX XX XX XX XX XX XX XX XX XX
XX XX XX XX XX XX XX XX XX XX XX XX XX XX XX XX XX XX XX XX XX XX XX XX XX XX XX XX XX XX
XX XX XX XX XX XX XX XX XX XX XX XX XX XX XX XX XX XX XX XX XX XX XX XX XX XX XX XX XX XX
XX XX XX XX XX XX XX XX XX XX XX XX XX XX XX XX XX XX XX XX XX XX XX XX XX XX XX XX XX XX
XX XX XX XX XX XX XX XX XX XX XX XX XX XX XX XX XX XX XX XX XX XX XX XX XX XX XX XX XX XX
XX XX XX XX XX XX XX XX XX XX XX XX XX XX XX XX XX XX XX XX XX XX XX XX XX XX XX XX XX XX
I
1
ME
F1
908 384
PHY
0
C
0
P
50 380