M04
res/img/lvl4icon.png
30
17
3
32
32
B
XX XX XX XX XX XX XX XX XX XX XX XX XX XX XX XX XX XX XX XX XX XX XX XX XX XX XX XX XX XX 
XX XX XX XX XX XX XX XX XX XX XX XX XX XX XX XX XX XX XX XX XX XX XX XX XX XX XX XX XX XX
XX XX XX XX XX XX XX XX XX XX XX XX XX XX XX XX XX XX XX XX XX XX XX XX XX XX XX XX XX XX 
XX XX XX XX XX XX XX XX XX XX XX XX XX XX XX XX XX XX XX XX XX XX XX XX XX XX XX XX XX XX
XX XX XX XX XX XX XX XX XX XX XX XX XX XX XX XX XX XX XX XX XX XX XX XX XX XX XX XX XX XX 
XX XX XX XX XX XX XX XX XX XX XX XX XX XX XX XX XX XX XX XX XX XX XX XX XX XX XX XX XX XX
XX XX XX XX XX XX XX XX XX XX XX XX XX XX XX XX XX XX XX XX XX XX XX XX XX XX XX XX XX XX 
XX XX XX XX XX XX XX XX XX XX XX XX XX XX XX XX XX XX XX XX XX XX XX XX XX XX XX XX XX XX
XX XX XX XX XX XX XX XX XX XX XX XX XX XX XX XX XX XX XX XX XX XX XX XX XX XX XX XX XX XX
XX XX XX XX XX XX XX XX XX XX XX XX XX XX XX XX XX XX XX XX XX XX XX XX XX XX XX XX XX XX 
XX XX XX XX XX XX XX XX XX XX XX XX XX XX XX XX XX XX XX XX XX XX XX XX XX XX XX XX XX XX
XX XX XX XX XX XX XX XX XX XX XX XX XX XX XX XX XX XX XX XX XX XX XX XX XX XX XX XX XX XX
XX XX XX XX XX XX XX XX XX XX XX XX XX XX XX XX XX XX XX XX XX XX XX XX XX XX XX XX XX XX 
XX XX XX XX XX XX XX XX XX XX XX XX XX XX XX XX XX XX XX XX XX XX XX XX XX XX XX XX XX XX
XX XX XX XX XX XX XX XX XX XX XX XX XX XX XX XX XX XX XX XX XX XX XX XX XX XX XX XX XX XX
XX XX XX XX XX XX XX XX XX XX XX XX XX XX XX XX XX XX XX XX XX XX XX XX XX XX XX XX XX XX 
XX XX XX XX XX XX XX XX XX XX XX XX XX XX XX XX XX XX XX XX XX XX XX XX XX XX XX XX XX XX  
O
VE VE VE VE VE VE VE VE VE VE VE VE VE VE VE VE VE VE VE VE VE VE VE VE VE VE VE VE VE VE 
VE XX XX XX XX XX XX XX XX XX XX XX XX VE XX XX XX XX XX XX XX XX XX XX XX XX XX XX XX VE 
VE XX XX XX XX XX XX XX XX XX XX XX XX VE XX XX XX XX XX XX XX XX XX XX XX XX XX XX XX VE 
VE XX XX XX XX XX XX XX XX XX XX XX XX VE XX XX XX XX XX XX XX XX XX XX XX XX XX XX XX VE 
VE XX XX XX XX XX XX XX XX XX XX XX XX VE XX XX XX XX XX XX XX XX XX XX XX XX XX XX XX VE 
VE VE VE XX XX XX XX XX XX XX XX XX XX VE XX XX XX XX XX XX XX XX XX VE XX XX XX XX XX VE 
VE VE VE XX XX XX XX XX XX XX XX XX XX VE VE VE VE XX XX XX XX XX XX VE XX XX XX XX XX VE 
VE XX XX XX XX XX XX XX XX XX XX XX XX VE VE VE VE VE VE VE VE VE L2 VE XX XX XX XX XX VE 
VE VE VE W0 W0 W7 XX XX XX XX XX XX XX XX XX XX XX XX XX XX XX XX L0 XX XX XX XX XX XX VE 
VE VE VE W2 W2 W3 XX XX XX XX XX XX XX XX XX XX XX XX XX XX XX XX L0 XX XX XX XX XX XX VE 
VE VE VE W2 W2 W3 XX XX XX XX XX XX XX XX XX XX XX XX XX XX XX XX L0 XX XX XX XX XX XX VE 
W2 W2 W2 W2 W2 W3 XX XX XX XX XX XX XX XX XX XX XX XX XX XX XX XX L1 XX XX XX XX XX XX VE 
W2 W2 W2 W2 W2 W3 XX XX XX XX XX XX XX XX XX XX XX W6 W0 W0 W0 W0 W7 XX XX XX XX XX XX VE 
W2 W2 W2 W2 W2 W3 XX XX XX XX XX VE XX XX W6 W0 W0 W2 W2 W2 W2 W2 W3 XX XX XX XX XX XX VE
W2 W2 W2 W2 W2 W3 XX XX XX XX VE VE XX XX W1 W2 W2 W2 W2 W2 W2 W2 W3 XX XX XX XX XX XX VE 
W2 W2 W2 W2 W2 W2 W0 W0 W0 W0 W0 W7 XX XX W1 W2 W2 W2 W2 W2 W2 W2 W3 XX XX XX XX XX XX VE 
W2 W2 W2 W2 W2 W2 W2 W2 W2 W2 W2 W3 XX XX W1 W2 W2 W2 W2 W2 W2 W2 W3 XX XX XX XX XX XX VE 
C
XX XX XX XX XX XX XX XX XX XX XX XX XX XX XX XX XX XX XX XX XX XX XX XX XX XX XX XX XX XX
XX XX XX XX XX XX XX XX XX XX XX XX XX XX XX XX XX XX XX XX XX XX XX XX XX XX XX XX XX XX
XX XX XX XX XX XX XX XX XX XX XX XX XX XX XX XX XX XX XX XX XX XX XX XX XX XX XX XX XX XX
XX XX XX XX XX XX XX XX XX XX XX XX XX XX XX XX XX XX XX XX XX XX XX XX XX XX XX XX XX XX
XX XX XX XX XX XX XX XX XX XX XX XX XX XX XX XX XX XX XX XX XX XX XX XX XX XX XX XX XX XX
XX XX XX XX XX XX XX XX XX XX XX XX XX XX XX XX XX XX XX XX XX XX XX XX XX XX XX XX XX XX
XX XX XX XX XX XX XX XX XX XX XX XX XX XX XX XX XX XX XX XX XX XX XX XX XX XX XX XX XX XX
XX XX XX XX XX XX XX XX XX XX XX XX XX XX XX XX XX XX XX XX XX XX XX XX XX XX XX XX XX XX
XX XX XX XX XX XX XX XX XX XX XX XX XX XX XX XX XX XX XX XX XX XX XX XX XX XX XX XX XX XX
XX XX XX XX XX XX XX XX XX XX XX XX XX XX XX XX XX XX XX XX XX XX XX XX XX XX XX XX XX XX
XX XX XX XX XX XX XX XX XX XX XX XX XX XX XX XX XX XX XX XX XX XX XX XX XX XX XX XX XX XX
XX XX XX XX XX XX XX XX XX XX XX XX XX XX XX XX XX XX XX XX XX XX XX XX XX XX XX XX XX XX
XX XX XX XX XX XX XX XX XX XX XX XX XX XX XX XX XX XX XX XX XX XX XX XX XX XX XX XX XX XX
XX XX XX XX XX XX XX XX XX XX XX XX XX XX XX XX XX XX XX XX XX XX XX XX XX XX XX XX XX XX
XX XX XX XX XX XX XX XX XX XX XX XX XX XX XX XX XX XX XX XX XX XX XX XX XX XX XX XX XX XX
XX XX XX XX XX XX XX XX XX XX XX XX XX XX XX XX XX XX XX XX XX XX XX XX XX XX XX XX XX XX
XX XX XX XX XX XX XX XX XX XX XX XX XX XX XX XX XX XX XX XX XX XX XX XX XX XX XX XX XX XX
I
5
ME
F1
32 224
DR
F2
64 224
0
MP
F3
224 288
864 288
45
0
0
PP
196 464
F2
PP
480 176
F3
PHY
1
SQ
576 192
C
0
P
105 220