M05
res/img/lvl5icon.png
30
17
3
32
32
B
XX XX XX XX XX XX XX XX XX XX XX XX XX XX XX XX XX XX XX XX XX XX XX XX XX XX XX XX XX XX 
XX XX XX XX XX XX XX XX XX XX XX XX XX XX XX XX XX XX XX XX XX XX XX XX XX XX XX XX XX XX
XX XX XX XX XX XX XX XX XX XX XX XX XX XX XX XX XX XX XX XX XX XX XX XX XX XX XX XX XX XX 
XX XX XX XX XX XX XX XX XX XX XX XX XX XX XX XX XX XX XX XX XX XX XX XX XX XX XX XX XX XX
XX XX XX XX XX XX XX XX XX XX XX XX XX XX XX XX XX XX XX XX XX XX XX XX XX XX XX XX XX XX 
XX XX XX XX XX XX XX XX XX XX XX XX XX XX XX XX XX XX XX XX XX XX XX XX XX XX XX XX XX XX
XX XX XX XX XX XX XX XX XX XX XX XX XX XX XX XX XX XX XX XX XX XX XX XX XX XX XX XX XX XX 
XX XX XX XX XX XX XX XX XX XX XX XX XX XX XX XX XX XX XX XX XX XX XX XX XX XX XX XX XX XX
XX XX XX XX XX XX XX XX XX XX XX XX XX XX XX XX XX XX XX XX XX XX XX XX XX XX XX XX XX XX
XX XX XX XX XX XX XX XX XX XX XX XX XX XX XX XX XX XX XX XX XX XX XX XX XX XX XX XX XX XX 
XX XX XX XX XX XX XX XX XX XX XX XX XX XX XX XX XX XX XX XX XX XX XX XX XX XX XX XX XX XX
XX XX XX XX XX XX XX XX XX XX XX XX XX XX XX XX XX XX XX XX XX XX XX XX XX XX XX XX XX XX
XX XX XX XX XX XX XX XX XX XX XX XX XX XX XX XX XX XX XX XX XX XX XX XX XX XX XX XX XX XX 
XX XX XX XX XX XX XX XX XX XX XX XX XX XX XX XX XX XX XX XX XX XX XX XX XX XX XX XX XX XX
XX XX XX XX XX XX XX XX XX XX XX XX XX XX XX XX XX XX XX XX XX XX XX XX XX XX XX XX XX XX
XX XX XX XX XX XX XX XX XX XX XX XX XX XX XX XX XX XX XX XX XX XX XX XX XX XX XX XX XX XX 
XX XX XX XX XX XX XX XX XX XX XX XX XX XX XX XX XX XX XX XX XX XX XX XX XX XX XX XX XX XX  
O
VE VE VE VE VE VE VE VE VE VE VE VE VE VE VE VE VE VE VE VE VE VE VE VE VE VE VE VE VE VE 
VE VE VE VE VE VE VE VE VE VE VE VE VE XX XX XX XX XX XX XX XX XX XX XX XX VE VE VE VE VE 
VE XX XX XX XX XX XX XX VE VE VE VE VE XX XX XX XX XX XX XX XX XX XX XX XX VE VE VE VE VE 
VE XX XX XX XX XX XX XX VE VE VE VE VE XX XX XX XX XX XX XX XX XX XX VE VE VE VE VE VE VE 
VE XX XX XX XX XX XX XX VE VE VE VE VE XX XX XX XX XX XX XX XX XX XX XX VE VE VE VE VE VE 
VE XX XX XX XX XX XX XX VE VE VE VE VE XX XX XX XX XX XX XX XX XX XX VE VE VE VE VE VE VE 
VE XX VE VE VE VE L2 VE VE VE VE VE VE XX XX XX XX XX XX XX XX XX XX VE VE VE VE VE VE VE 
VE XX XX XX XX XX L0 XX VE VE XX XX XX XX XX XX XX XX XX XX XX XX XX VE VE VE VE VE VE VE 
VE XX XX XX XX XX L0 XX VE XX XX XX XX XX XX XX XX XX XX XX XX XX XX VE VE VE VE VE VE VE 
VE XX XX XX XX XX L0 XX VE XX XX XX XX XX XX XX VE VE VE VE VE VE VE VE VE VE VE VE VE VE 
VE XX XX XX XX XX L0 XX VE XX XX XX XX XX XX XX VE VE VE VE VE VE VE VE VE VE VE VE VE VE 
VE XX XX XX XX XX L0 XX VE XX XX XX XX XX XX XX VE VE VE VE VE VE VE VE VE VE VE VE VE VE 
VE XX XX XX XX XX L0 XX VE XX XX XX XX XX XX XX VE VE VE VE VE VE VE VE VE VE VE VE VE VE 
VE XX XX XX XX XX L0 XX VE XX XX XX XX XX XX XX VE VE VE VE VE VE VE VE VE VE VE VE VE VE
VE XX XX XX XX XX L0 XX VE XX XX XX XX XX XX XX VE VE VE VE VE VE VE VE VE VE VE VE VE VE 
VE XX XX XX XX XX L1 XX XX XX XX XX XX XX XX XX VE VE VE VE VE VE VE VE VE VE VE VE VE VE 
VE VE VE VE VE VE VE VE VE VE VE VE VE VE VE VE VE VE VE VE VE VE VE VE VE VE VE VE VE VE
C
XX XX XX XX XX XX XX XX XX XX XX XX XX XX XX XX XX XX XX XX XX XX XX XX XX XX XX XX XX XX
XX XX XX XX XX XX XX XX XX XX XX XX XX XX XX XX XX XX XX XX XX XX XX XX XX XX XX XX XX XX
XX XX XX XX XX XX XX XX XX XX XX XX XX XX XX XX XX XX XX XX XX XX XX XX XX XX XX XX XX XX
XX XX XX XX XX XX XX XX XX XX XX XX XX XX XX XX XX XX XX XX XX XX XX XX XX XX XX XX XX XX
XX XX XX XX XX XX XX XX XX XX XX XX XX XX XX XX XX XX XX XX XX XX XX XX XX XX XX XX XX XX
XX XX XX XX XX XX XX XX XX XX XX XX XX XX XX XX XX XX XX XX XX XX XX XX XX XX XX XX XX XX
XX XX XX XX XX XX XX XX XX XX XX XX XX XX XX XX XX XX XX XX XX XX XX XX XX XX XX XX XX XX
XX XX XX XX XX XX XX XX XX XX XX XX XX XX XX XX XX XX XX XX XX XX XX XX XX XX XX XX XX XX
XX XX XX XX XX XX XX XX XX XX XX XX XX XX XX XX XX XX XX XX XX XX XX XX XX XX XX XX XX XX
XX XX XX XX XX XX XX XX XX XX XX XX XX XX XX XX XX XX XX XX XX XX XX XX XX XX XX XX XX XX
XX XX XX XX XX XX XX XX XX XX XX XX XX XX XX XX XX XX XX XX XX XX XX XX XX XX XX XX XX XX
XX XX XX XX XX XX XX XX XX XX XX XX XX XX XX XX XX XX XX XX XX XX XX XX XX XX XX XX XX XX
XX XX XX XX XX XX XX XX XX XX XX XX XX XX XX XX XX XX XX XX XX XX XX XX XX XX XX XX XX XX
XX XX XX XX XX XX XX XX XX XX XX XX XX XX XX XX XX XX XX XX XX XX XX XX XX XX XX XX XX XX
XX XX XX XX XX XX XX XX XX XX XX XX XX XX XX XX XX XX XX XX XX XX XX XX XX XX XX XX XX XX
XX XX XX XX XX XX XX XX XX XX XX XX XX XX XX XX XX XX XX XX XX XX XX XX XX XX XX XX XX XX
XX XX XX XX XX XX XX XX XX XX XX XX XX XX XX XX XX XX XX XX XX XX XX XX XX XX XX XX XX XX
I
7
ME
F1
782 64
DR
F2
258 480
0
MP
F3
448 494
448 288
40
0
1
MP
F4
672 270
672 96
40
0
1
IS
32 484
F2
IS
384 484
F3
IS
736 132
F4
PHY
1
SQ
142 172
C
0
P
96 480