M09
res/img/lvl9icon.png
30
17
3
32
32
B
XX XX XX XX XX XX XX XX XX XX XX XX XX XX XX XX XX XX XX XX XX XX XX XX XX XX XX XX XX XX 
XX XX XX XX XX XX XX XX XX XX XX XX XX XX XX XX XX XX XX XX XX XX XX XX XX XX XX XX XX XX
XX XX XX XX XX XX XX XX XX XX XX XX XX XX XX XX XX XX XX XX XX XX XX XX XX XX XX XX XX XX 
XX XX XX XX XX XX XX XX XX XX XX XX XX XX XX XX XX XX XX XX XX XX XX XX XX XX XX XX XX XX
XX XX XX XX XX XX XX XX XX XX XX XX XX XX XX XX XX XX XX XX XX XX XX XX XX XX XX XX XX XX 
XX XX XX XX XX XX XX XX XX XX XX XX XX XX XX XX XX XX XX XX XX XX XX XX XX XX XX XX XX XX
XX XX XX XX XX XX XX XX XX XX XX XX XX XX XX XX XX XX XX XX XX XX XX XX XX XX XX XX XX XX 
XX XX XX XX XX XX XX XX XX XX XX XX XX XX XX XX XX XX XX XX XX XX XX XX XX XX XX XX XX XX
XX XX XX XX XX XX XX XX XX XX XX XX XX XX XX XX XX XX XX XX XX XX XX XX XX XX XX XX XX XX
XX XX XX XX XX XX XX XX XX XX XX XX XX XX XX XX XX XX XX XX XX XX XX XX XX XX XX XX XX XX 
XX XX XX XX XX XX XX XX XX XX XX XX XX XX XX XX XX XX XX XX XX XX XX XX XX XX XX XX XX XX
XX XX XX XX XX XX XX XX XX XX XX XX XX XX XX XX XX XX XX XX XX XX XX XX XX XX XX XX XX XX
XX XX XX XX XX XX XX XX XX XX XX XX XX XX XX XX XX XX XX XX XX XX XX XX XX XX XX XX XX XX 
XX XX XX XX XX XX XX XX XX XX XX XX XX XX XX XX XX XX XX XX XX XX XX XX XX XX XX XX XX XX
XX XX XX XX XX XX XX XX XX XX XX XX XX XX XX XX XX XX XX XX XX XX XX XX XX XX XX XX XX XX
XX XX XX XX XX XX XX XX XX XX XX XX XX XX XX XX XX XX XX XX XX XX XX XX XX XX XX XX XX XX 
XX XX XX XX XX XX XX XX XX XX XX XX XX XX XX XX XX XX XX XX XX XX XX XX XX XX XX XX XX XX  
O
VE VE VE VE VE VE VE VE VE VE VE VE VE VE VE VE VE VE VE VE VE VE VE VE VE VE VE VE VE VE 
VE VE VE XX XX VE VE VE VE XX XX XX XX XX XX VE VE XX XX XX XX XX XX XX XX XX XX XX VE VE 
VE VE VE XX XX VE VE VE VE XX XX XX XX XX XX VE VE XX XX XX XX XX XX XX XX XX XX XX VE VE 
VE VE VE XX XX VE VE VE VE XX XX XX XX XX XX VE VE XX XX XX XX XX XX XX XX XX XX XX VE VE 
VE VE VE XX XX XX XX XX XX XX XX XX XX XX XX VE XX XX XX XX XX XX XX XX XX VE VE VE VE VE 
XX XX XX XX XX XX XX XX XX XX XX XX XX XX XX VE VE XX XX XX XX XX XX XX XX VE VE VE VE VE 
VE VE VE XX XX VE XX VE VE XX XX XX XX XX XX XX XX XX XX XX XX XX XX XX XX VE VE VE VE VE 
VE VE VE XX XX VE XX XX XX XX XX XX XX XX XX XX XX XX XX XX XX XX XX XX XX VE VE VE VE VE 
VE VE VE XX XX VE XX XX XX XX XX XX XX XX XX XX XX XX XX XX XX XX XX XX XX VE VE VE VE VE 
VE VE VE VE VE VE XX XX XX L2 VE VE VE VE VE L2 XX VE VE VE VE VE VE VE VE VE VE VE VE VE 
VE VE VE VE VE VE XX XX XX L0 VE VE VE VE VE L0 XX XX VE VE VE VE VE VE VE VE VE VE VE VE 
VE VE VE VE VE VE XX XX XX L1 VE VE VE VE VE L1 XX XX XX XX XX VE VE VE VE VE VE VE VE VE 
VE VE VE VE VE VE VE VE VE VE VE VE VE VE VE VE VE VE VE VE VE VE VE VE VE VE VE VE VE VE 
VE VE VE VE VE VE VE VE VE VE VE VE VE VE VE VE VE VE VE VE VE VE VE VE VE VE VE VE VE VE
VE VE VE VE VE VE VE VE VE VE VE VE VE VE VE VE VE VE VE VE VE VE VE VE VE VE VE VE VE VE
VE VE VE VE VE VE VE VE VE VE VE VE VE VE VE VE VE VE VE VE VE VE VE VE VE VE VE VE VE VE
VE VE VE VE VE VE VE VE VE VE VE VE VE VE VE VE VE VE VE VE VE VE VE VE VE VE VE VE VE VE
C
XX XX XX XX XX XX XX XX XX XX XX XX XX XX XX XX XX XX XX XX XX XX XX XX XX XX XX XX XX XX
XX XX XX XX XX XX XX XX XX XX XX XX XX XX XX XX XX XX XX XX XX XX XX XX XX XX XX XX XX XX
XX XX XX XX XX XX XX XX XX XX XX XX XX XX XX XX XX XX XX XX XX XX XX XX XX XX XX XX XX XX
XX XX XX XX XX XX XX XX XX XX XX XX XX XX XX XX XX XX XX XX XX XX XX XX XX XX XX XX XX XX
XX XX XX XX XX XX XX XX XX XX XX XX XX XX XX XX XX XX XX XX XX XX XX XX XX XX XX XX XX XX
XX XX XX XX XX XX XX XX XX XX XX XX XX XX XX XX XX XX XX XX XX XX XX XX XX XX XX XX XX XX
XX XX XX XX XX XX XX XX XX XX XX XX XX XX XX XX XX XX XX XX XX XX XX XX XX XX XX XX XX XX
XX XX XX XX XX XX XX XX XX XX XX XX XX XX XX XX XX XX XX XX XX XX XX XX XX XX XX XX XX XX
XX XX XX XX XX XX XX XX XX XX XX XX XX XX XX XX XX XX XX XX XX XX XX XX XX XX XX XX XX XX
XX XX XX XX XX XX XX XX XX XX XX XX XX XX XX XX XX XX XX XX XX XX XX XX XX XX XX XX XX XX
XX XX XX XX XX XX XX XX XX XX XX XX XX XX XX XX XX XX XX XX XX XX XX XX XX XX XX XX XX XX
XX XX XX XX XX XX XX XX XX XX XX XX XX XX XX XX XX XX XX XX XX XX XX XX XX XX XX XX XX XX
XX XX XX XX XX XX XX XX XX XX XX XX XX XX XX XX XX XX XX XX XX XX XX XX XX XX XX XX XX XX
XX XX XX XX XX XX XX XX XX XX XX XX XX XX XX XX XX XX XX XX XX XX XX XX XX XX XX XX XX XX
XX XX XX XX XX XX XX XX XX XX XX XX XX XX XX XX XX XX XX XX XX XX XX XX XX XX XX XX XX XX
XX XX XX XX XX XX XX XX XX XX XX XX XX XX XX XX XX XX XX XX XX XX XX XX XX XX XX XX XX XX
XX XX XX XX XX XX XX XX XX XX XX XX XX XX XX XX XX XX XX XX XX XX XX XX XX XX XX XX XX XX
I
8
ME
F1
654 352
DR
F2
178 128
0
DR
F3
608 352
0
MP
F4
414 160
0 160
50
0
1
MP
F5
736 269
736 192
70
1
1
PP
364 271
F2
IS
522 132
F4
PP
106 271
F3
PHY
1
SQ
838 110
C
0
P
230 352